XXXXXXXXX
XPX    GX
X X  X XX
X   U   X
XXXXXXXXX